PPPPPPPPPPPPPPPPPP
P                P
P   §            P
PPPP    P      § P
P+      PPP      P
P         PPPPPPPP
PPP    P§       +P
P      P        PP
P §   +P+       P
P     PPPPP+    £P
PPPPPPP    PPPPPPP