PPPPPPPPPPPPPPPPPP
P£               P
P    §           P
PPPPPPP          P
P+            §  P
P         PPPPPPPP
P    PPP         P
P      P§     §  P
P     +P   PPPPPPP
P  +++PPPPPP
PPPPPPP