 PPPPPPPPP   
P   +     PPPPPPPP
P        §       P
P §  P      §PPPPP
P    P +     P
P    P       P
P    P   +§  PPPPP
P    P £         P
P              § P
P          P     P
 PPPPPPPPPPPPPPPPP



